40 30
1111111111111111111111111111111111111111
1111111111111111111111111100000000000001
1111111111111111111111111100000000000001
1111111111000000001000001100000000000001
1111111111000000001000001100000000000001
1111111111000000000000001100000000000001
1111111111000000000000001100000000000001
1111111111000000001000001100000000000001
1111111111000000001000001100000000000001
1111111111111100111100111100000000000001
1000000001000000000000000111100001111111
1000000001000000000000000100000000000111
1000000001000000000000000100000000000111
1000000001000000000000000000000000000111
1000000000000000000000000000000000000111
1000000000000000000000000000000000000111
1000000001000000000000000000000000000111
1000000001000000000000000100000000000111
1000000001000000000000000100000000000111
1000000001000000000000000111100001111111
1111111111111100111100111100000000000001
1111111111000000001000001100000000000001
1111111111000000001000001100000000000001
1111111111000000001000001100000000000001
1111111111000000001000001100000000000001
1111111111000000001000001100000000000001
1111111111000000001000001100000000000001
1111111111111111111111111100000000000001
1111111111111111111111111100000000000001
1111111111111111111111111111111111111111
3
models/textured/ArmadilloJade.ply -1
models/bunny.ply 2
models/dragon.ply 1
23
2
31 0 15
3 3 3
0
29 0 2
1 1 1
0
32 0 2
1 1 1
0
35 0 2
1 1 1
0
30 0 4
1 1 1
0
33 0 4
1 1 1
0
36 0 4
1 1 1
0
29 0 6
1 1 1
1
29 0 22
1 1 1
1
31 0 22
1 1 1
1
33 0 22
1 1 1
1
35 0 22
1 1 1
1
37 0 22
1 1 1
1
29 0 24
1 1 1
1
31 0 24
1 1 1
1
33 0 24
1 1 1
1
35 0 24
1 1 1
1
37 0 24
1 1 1
1
29 0 26
1 1 1
1
31 0 26
1 1 1
1
33 0 26
1 1 1
1
35 0 26
1 1 1
1
37 0 26
1 1 1